A COTE DE :  YA PANGA A
ABAISSEMENT : KONOUSSA
ABAISSER :  KONOUSSA
ABAIDON  :  TOUKOU    
ABANDONNER : TOUKOU
ABATTRE  : KWANGA
ABATTRE (quelque chose): KWANGA  
ABATTRE (un etre vivant): BOMA     
ABCES : IBIMBITI
ABCES : IVANGA
ABDIQUER : BISSA      
ABDIQUER :  NIAGHA  
ABEILLE  :  NIOUGHI
ABOIEMENT : BEGHA
ABONDER  :  LOTOLA  
ABORDER : BONDO       
ABOYER : BEGRA      
ABSENT : VELE
Il est absent : ndè na vele  
ACCABLER :	     YILOUSSA       
ACCABLER : YILA     
ACCORDER : CHINGA  
S'ACCORDER : YEBENE  
ACCOSTER : TSEKE
ACCOUCHER : BOTA     
S'ACCOUPLER :    LALA     
ACCROCHER : BANDOUGHA    
S'ACCROCHER :    KAGHA   
ACCUSER : KOUTOULOU    
ACHAT   :   LESSOUMBOU
ACHETER :   SOMBA   
ACHETEUR :    MOUCHOUMBI
ACHEVER  :   MANOUSSA
ACHEVER quelqu'un :  TOUKOULOU 
ACHEVER  :      MANA
TERMINER : MANA
ACIDE  :NGUEGNI
ACTION :   KWE
ADOLESCENT :   MOUFOUDOU
ADOLESCENTE :  NOMBA
ADORER quelqu'un:     BONDO     
QUELQU'UN : MOUTOU
ADORER quelqu'un :    YOUMOUSSOU 
ADORER quelque chose : BONDO    
ADOSSER  :   BANDOUSSA 
S'ADOSSER   :  BANDOUNA 
ADOUCIR   :   KOLICHI      
ADULTE : NGWAMOUTOU
ADULTERE :    BOUKELI
AFFAMER  :   KWA NDZALA
AFFILER  :   (un couteau)  CHIBA    
AFFIRMER :    CHILOULA
AFFLUENT :   NWANANDZELI
AGE : BILEMA 
quel age as-tu ? : wè bilema kwè ?
quelqu'un d'agé : NGWAMOUTOU
AGES:   BILEMA
AGITER : TSOKASSA
AGITER : TSOKOUSSA     
AGRANDIR  :   NEBOUSSE 
AIDER : YAMOUSSA 
AIGLE : MBEDA
AIGUILLE   :  TSONGUI
AILE :    LEPEPI 
AIMER :  TONDO     
AJOUTER : BWESSE     
ALBINOS : IKOUYI
ALIMENTS : BIELA
ALLER ET VENIR : YENDE NA YA 
ALLER JUSQU'AU BOUT  : VIKASSA 
S'ALLONGER   :    SOKOUGHA 
ALLONGER     :    SOKOULA 
ALLONS MARCHONS!   :   TSWE NDA GNI
ETRE ALLUMÉ  :   YA NAMA
S'ALLUMER    :    NAMA     
ALLUMER  : NAMOUSSA 
ALORS  : TO YANA
ALORS  : AKA
AMER   : KELI
AMI    : MBEGHI
AMITIE  : IMBEGHI
AMOLLIR :  KOLOUSSO 
AMONT  : TANDA
AMONT  : OUKEGHA
AMOUR  : LETONDO
AMULETTE : MOUCHIOUGHOU
PORTEUR D'AMULETTES  :    NGA BILONGO
ANANAS  : IBA
ANANAS :  LELANGA
ANCETRE : IBOUTOU
ANCETRE : MOUKOUTOU
ANCETRES  :    BIBOUTOU
ANCETRES ELOIGNES : BAKOUTOU :  BAKALA
ANCIEN   :   OUNDJINGA
TRÈS ANCIENNEMENT :   VA KALA KALA
ANCIENNETE  : OUDJINGA
ANEANTIR   :  GHODOUSSOU
ANEANTIR    TSAMOUNA    
ANGLE :     MOUSSOUGHOU
ANGOISSE   :  BOMO
ANGOISSE  :   MANGONGO
ANIMAL DECOUPE   :   BIBETE
ANIMAUX   :   BANIAMA
ANNONCER  :   LELE    
ANNONCER   :  LEBALA 
ANTILOPE DORMANTE :     ICHIBA
ANUS  : ICHOUMBI
APLANIR  :    TETESSE    
APPARAITRE  : POLOULA    
APPAT : TSALA
APPEL : MBELA 
APPELER :     TEDE    
APPORTER  :   TSWALA
S'APPUYER   :      CHINGANA    
S'APPUYER LEGEREMENT : CHIMA    
APRES DEMAIN : MBISSA MBEDI
ARACHIDE   :  LEPENDA
ARACHIDES  :  PENDA
ARAIGNEE  :   NDZANDA
ARAIGNEES  :  BANDZANDA
ARBALETE   :  NJEDI
ARBRE : MOUTI
ARBRES : MITI
ARC   :  BOUTA
ARC-EN-CIEL :  MOUGHIAMA
ARGENT : BADOLO
ARRACHER : KAKALA
ARRACHER avec les racines :    LATA    
ARRACHER du sol :  BILA    
ARRET : OUTCHIKA
ARRETE : TCHIKA
S'ARRETER   :    TCHIKA     
ARRIVEE : LEYA
ASSEYEZ-VOUS  : NDJALAGNI
ASSEZ  : TCHITSA
ASSEZ D'ARGENT : BADOLO TCHITSA
ASSIEDS-TOI :  NDJALA
ASSIETTE :ITENGUE
ASSIS  :  MOUTOU VA TSAGHALA
ATTACHER : GHADA     
ATTENDRE : KELE    
FAIRE ATTENTION   :   REMBELA
ATTISER : LOSSA    
ATTISER LE FEU  :  LOSSA CHA MBWAGHA
ATTRAPER : KWATA    
AU REVOIR  :    KA NA BWEDI
AU-DESSUS DE  :  GHOU YOULOU A
AUBERGINES   :  BATSEKI
AUDACE  : BOUVOTO
AUDITEUR : MOUYOUGHILI
AUDITEUR : MOUYOUGHI
AUGMENTATION :     LEKOMOUSSA
ELEVEMENT : LEKOUMOUSSA
AUJOURD'HUI  :  LOLO
AURICULAIRE  :  MOULEMBA TCHITCHO
AURORE : LETEDI LI TEMOUNE
AURORES : MIKIAKIA
AUSSI : KA
il est venu aussi : ne nde idi
toi aussi: na wè
vous auusi: na bekou na
AUTORITE   :   LENIANGA
AUTRE :      MOUKIMA
L'autre maison:      NDZOYENA
Une autre maison :   NDZOKIMA
AUTREFOIS  :   YAKALA
AUTRES hommes :     BATA BANA
les autres : BAKIMA
AVAL : BANDA
AVALER : MINA 
AVEUGLE :  WA VE LA MISSA
AVEUGLE : IPEPIDI
AVORTER : POSSA  DJIMI
AVORTER SPONTANEMENT : VESSE 
AVOUER : YAGHALA 


BAGAGE : MOUTETE
BAGAGES : MITETE
BAGARRE : MOUDJINGA
BAGARREUR  :   MOULWENI
BAGUE : LENGASSI
BAGUE :      MOULONGA     
doigt :  moulemba
BAIGNER : YOBICHI     
SE BAIGNER  : YOBO 
JE BAILLE   :     ME SA MIASSALA
BAILLEMENT   : MWASSALA
BAILLEMENTS  : MIASSALA
SE BAISSER   :   BANDANA     
BALAI : IKOMBOULO
BALAYER   :  KOMBOULO     
BALLE de fusil :      LECHANA
BALLON   :      NDAMBA
BAMBOU   :     LOUBECHI
BANANE : LEKO
BANANE DOUCE  : LETOTO
BANANES : MAKO
BANANES DOUCES  :  MATOTO
BANDELETTE  :  IRENDE
BANDIT : MOUBANGA
BARBE : MANDEDA
BARRIERE  :   MOUROUMBA
EN BAS DE LA MONTAGNE : YA TCHINA A MOUKOUDI
AU BAS DE : YA TCHINA A
AU PIED DE  : YA TCHINA A
BATAILLE   :  MOUDENGA
BATAILLE   :  MOUDJINGA
BATEAU  :   MBOUNGOU
PIROGUE : MBOUNGOU
BATISSEUR  :  MOUTOUNGUI
MAÇON : MOUTOUNGUI
BATON (pour marcher) :  MOUPANGA
BATON (pour se batttre) : MOUBOTO
BEAU  : BOUBWE
BEAU-FRERE  : MOUNDZELI
BEAU-PERE   : BOUKO BWA LEBAGHALA
BEAUCOUP     : BOULEGHI
BEAUTE : BOUBWE
BEAUX-PARENTS : BAKO
BEGAIEMENT  :  LEKOKOUNA
BELLE-MERE  : BOUKO BWA MOUKASSA
BELLE-MERE   : BOUKO BA MOUKASSA
BERCER : POPICHI 
BERCER UN ENFANT : POPICHI  MWANA
BETAIL : BIBODI
BETE  :      INDJILI
BETISE : BOUIDJILI
BIENVEILLANCE : BOUCHICHI
BILLE DE BOIS : LEKOUGNI
BLAGUE  : NDJESSE
PLAISANTERIE: NDJESSE
BLAMER : KAKBOUGHA 
BLANC (couleur) : YA FOU KOU
BLANC (race)  :   IBAMBA
BLANCHIR   : FOUKOUSSOU    
BLATTE : PECHI
BLESSER :     NEMOUSSE    
SE BLOTTIR  : PAPANA
BOEUF  :   N'GOMBO
BOIRE : NIODO
BOIS    (pour le feu) : KOUGNI
BOISSON  :    BI BOUGNWA
BOISSONS  :   BIANIO
BOITE DE CONSERVE :     FOYO
BONJOUR   :   WÈ NA SOGHA
BONTE : BOUBWE
BORD  : MOUBILOULA
BORD DE LA RIVIERE  : MOUGHOLI A NDZELI
BORGNE : IPIPIDI
BORGNES  :    BIPIPIDI
BOUCHE : MOUNIO
BOUCLE D'OREILLE  :  TCHIKA
BOUCLER la porte :  BENDA     
BOUCLES D'OREILLE  : BATCHIKA
BOUDER : SA MADZANGA
BOUE  : MOUBINGA
BOUGER  :   TSOKA     
BOUGER  :   TSOKOUSSA 
BOUILLIR  :   LEKE     
BOUILLIR   :  LAMBA
FAIRE BOUILLIR :      BOTIGHI 
BOUILLON    : BOTIGHI
BOUILLONNEMENT DE L'EAU   : TOGHO GWA MAMBA
BOUILLONNEMNENT  :   TOGHO
BOURRER UNE PIPE  :   SADA CHA IVOLO OUTSO CHINDZ
BOUT : TSOMBO
BOUTEILLE  :   PAKBA
BOUTON     :    IKIENGUE
GALE  : IKIENGUE
BOUTON  : LESSOSSO
BOUTON DE GALE :   KANA
BOUTONS avec pus :      MASSOSSO
BOUTS DES DOIGTS  :  MITSWE MIA MILEXBA
BOUTURES DE HANIOC   MITI MIA BAPITA
BOYAU  : MOUSSOPO
BOYAUX :  MISSOPO
BRACELET : MOULONGA
BRAISE  : MAKAKALA
BRANCARD  :  KWANGA
BRANCARD :     TCHIPOYI
BRANCHE du palmier :    IGHELE
BRANCHE D'ARBRE  : ITAKA
BRAS : GHOGHO
LES BRAS :   KIOGHO
BRAVO! : TSEMBI!
ETRE BREDOUILLE :  KIOGHO NA KIOGHO
ETRE BREDOUILLE :  VIDA    
BRILLER : NAKA    
BROUILLARD :    LEBOUNGUI
BROUSSE HABITEE :     PINDI
BROUSSE INEXPLOREE  :    LIBONGUI
BROUSSE INHABITEE : PINDA
BRUIT  : KELE
BRUIT DE PAS   :  KELE A MATEMBI
BRUITS DE PAS  :  LEKINDA LA MATEMBI
BRULER : TSOUGHOU   
BRULER LA PLANTATION  : TSOGHOU NIOUNGUI
BRUSQUEMENT : IMBAMBA
BRUSQUEMENT :     KOUBATI
BRUSQUEMENT :    BOUMBOUDOU
BUFFLE : NIEDI
BUFFLES : BANIEDI
BUVEUR  : MOUNIOUWI
BUVEURS : BANIOUWI
C'EST MOI :   ME
CABINETS DE TOILETTE :  MAKOUSSOU
CACHE SEXE : MOUBATI
CACHE SEXE  : CHI ISWEGHE GHOUTSOBOUSSOU
CACHER  : SWEGHE      
SE CACHER     : SWEME    
CACHER QUELQUE CHOSE  : SWEGHE       CHELA
CACHETTE : ISWEGHI
CACHETTES   :   BISWEGHI
CADAVRE : IBIMI
CADAVRE : MVOUMBI
CADEAU  : MAFOUTOU
CADEAU  :    MANDZOLO
CADENAS : POGHO
CADENAS ANCIEN :   MOUBINDAGHA
CAFARD : PECHI
CAHIER  : PEPI
CAILLOU : LEKANIA
CAISSE  : FOYO
CAISSE D'EMBALLAGE  :  IGHOUGHOUDOU
CALEBASSE : MBENDA
CALEBASSES  : MAMBENDA
CALER  : SOKA 
CALER UNE TABLE : KAGHOUSSA      
CAMELEON   :   YOUMBOULOUKOUYI
CAMION : LOTO
CAMPEMENT DE PYGMEES  : MVOUDOU
CAMPEMENT DE BROUSSE  :  ITSAKA
CAMPEMENT DE PYGMEES : MBANGOU
CAMPEMENTS DE PYGMEES  MAMBANGOU
CANARD DOMESTIQUE : IGHODO
CANARD SAUVAGE : IBADANGA
CANDEUR : BOUPOGHO
CANNE  :   MOUPANGA
CANNE A SUCRE : MOUSSOUNGOU
CANNES A SUCRE : MISSOUNGOU
CAOUTCHOUC  :  NDAMBA
JE NE SUIS PAS CAPABLE     :    MÈ NA N'IOUTOU VE
CAPRICE : NDZOLA
CAPRICE : POTSO
MAUVAIS CARACTERE  : BIKOU BIBIBI
CARAPACE   :   IBONGA
CARAPACES   :  BIBONGA
CARESSER    :  PELE 
CARREFOUR   : MAKOULOU
CASCADE : POBA
CASSER : BOGHOULO
CE : CHE
CE : WOU
CE N'EST PAS AINSI :   AGNI BOVE
CE N'EST PAS TOI : A WE VE
CE QUI CACHE LE DEVANT  : CHI ISWEGHE GHOUTSOBOUSSOU
CE SONT LESQUELLES?   :   BIO BIGNI ?
CE SONT LESQUELS?   :    BO BEGNI ?
CECI : CHENA
CECITE  :   BOUPIPIDI
CEINTRE :  MOULELAGHE
CEINTRES : MILELAGHE
CEINTURE  :  KWAMBA
CELIBATAIRE : INDENGA
CELUI-CI   : WO NABA
CELUI-CI :   CHINICHI
CELUI-CI :   WOUNOUWOU
CENDRE      LEFOUTOU
CENT : MOUKAMA
CENT FRANCS   : MAKOUMI MOLE
CENTRE :     MOUTEMA
CEREMONIE  : MOUBEKA
CERVELLE  :  BOUNDZOU
CES ARBRES   :   MITI MI
CES CHOSES  : BIELABI
CES HOMMES  : BATA BA
CESSER      : NI AGHA      
CHAGRIN     : OUROUNGOU
CHAGRIN     : TCHONGO
CHAIR : MOUSSOUNIOU
CHALEUR  :   NDZOUNGOULI
CHALEUR DU SOLEIL : NIANGA
CHAMBRE A COUCHER : TCHINANDZO
CHAMPIGNON  :  LEBOKO
CHANCE  :  NIOUTOU BOUBWE
CHANGER : SANDZA
CHANGER quelquechose : KALAGHA     
CHANGER DE VETEMENT  :  LWATA  LENGOYI LEKIMA
CHANSON  : LIMBA
CHANT    : LIMBA
CHANTEUR : MOUYIMBI
CHANTS  : KIMBA
CHANVRE  : YAMBA
CHAPEAU  : MOUPAKA
CHARBON   : LIKBIDA
CHASSE AU FILET : MBINGA
CHASSER (chasse) : BENGA
CHASSER (quelqu'un)  :   MFOUNDZOU   
CHASSEUR (amateur)   :   MOUBINGUI
CHASSEUR (professionnel) : MOUMBANDA
CHAT    :  MOUKOGHO
CHAT-HUANT : NOMBO
CHAUSSURE : LETEMBI
CHAUVE-SOURIS :   LEPOULIGOU
LA PIROGUE CHAVIRE :      MBOUNGOU  I ITAGHA
CHAVIRER : ITAGHA 
CHEF   :  CHEFA
CHEF   :   KOUKOU
CHEF    :  CHEPA
CHEF DE FAMILLE  : MOUNDOMBA
CHEFS   :  BAKOUMOU
CHEMIN   : NDZELA
CHENILLE  :   ITCHITSOUDA
CHENILLE POILUE  : ITCHITSADA
CHENILLES   :  BITCHITSOUDA
CHERCHER    :  SAGHA     
CHEVEU : LETSOUGHI
CHEVEUX : TSOUGHI
CHEVILLE   :   LEKOUKOU
CHEVRE : A     TABA
CHEVRON : MOUKOKOLO
CHEVRON  : MOUKAMBA
CHEVRONS   :   MIKOKOLO
CHEZ  : GHOUMBOGHA
CHIEN : MVWENDI
CHIFFRE : LEPITA LA RANGA
CHIFFRE : NGUINDZA
CHIMPANZE  :   KOULOU
CHIQUE : NIONGO
CHOISIR : SOLO     
CHOSE : CHELA
CHOSE CHERIE :  CHELA CHA MOUTEMA
CHOUETTE   :   IBIDA
CHUCHOTEMENT :  WEDINI
CHUCHOTEMENTS : MAWEDIAWEDI
CHUCHOTER   :  WEDANA    
CHUTE : PABA
CICATRICE  :   IVIDI
CIEL :  YOULOU
CIEUX  : MAYOULOU
CIL  :  KONGUI
CILS :  MAKONGUI
CIMETIERE  :   NGUILA MAGNIMA
CINQ  : BITANA
CINQUANTE   :  BADOLO LEKOUMI
CINQUANTIEME : CHA MAKOUMI MATANA
CINQUIEME :    MOUTANA
CITRON : LELOUCHI
CITROUILLE   : LELENGUE
CITROUILLES  : MALENGUE
CIVETTE : MOUNGANIA
CLAIR  : CHA TENDEGHE
CLAIR DE LUNE : MOUDANGA
VOIR CLAIREMENT :    MONO VELE
CLAN   : IBANDA
CLAUDIQUER   : TSOUTSOUGHOU   
CLAVICULE   :  MOUNGONGOBI
CLEF  : ITCHEPI
CLEFS : BITCHEPI
CLIGNER DES YEUX   :  PATALA CHA MISSA
CLITORIS   :   MOUTONGUI
PETIT CLOU : TSEDE
GRANDS CLOUS  : BATCHONGO
PETITS CLOUS  :  BATSEDE
COCCYX : MOUKOUROUKOUTOU
COCHON : MOUBONGO
COCHONS : MABEKBE
COEUR  : MOUTEMA
COGNER : BOLA    
COIFFER : MFOUGHOU
COLERE : KECHI
COLLER : KATOUNA
COLLER : KATOUSSA
COLLIER DE CUIVRE  :   MOULONGA
COLLINE : IBENDAKA
COLONNE : MOUGONGO
COKBIEN ?   :   KWE ?
COMMANDER   :   TOMA    
COMME   : NGA NA
COMMENCER :     BANDA    
COMMENT  ?   :   BOUGNI    ?
COMMENT DIT-ON   ?  :  BOUGNI BALELE ?
COMMERÇANT : MOUCHOUMBICHI
COMMERCE :   SOMBOUSSA
COMPARAISON : IFWENICHI
COMPARER  : FWANASSA 
COMPRENDRE : YOGHA     
COMPTER   :  TALA     
COMPTER SUR QUELQU'UN : SA  CHI TA
CONCILIER  : NONGUICHI 
CONCOMBRE  : NDZAKA
CONCUBINAGE : LEMBAKA
CONCUBINAGE : BOU MBAKA
CONCUBINE  : MBAKA
CONDUIRE quelqu'un :      TOSSO     
CONDUIRE la voiture :  BETA     
FAIRE CONFIANCE : SA CHITA
CONFIRMER : CHINGA      
CONFLUENT : MALA
CONNAITRE  : YABA     
FAIRE CONNAITRE : YABOUSSA  
CONSEIL   :  NDONGUI
CONSEILLER :     MOULONGUI
CONSEILLER :  LONGO 
CONSOLER   :  POPICHI
CONSULTER LE GUERISSEUR   :  TESSE NGANGA
CONTE : LESSABA
COQUILLE D'OEUF   :   IBONGA CHA LEMVOUNGOU
CORBEILLE :   MBELE
CORDE : MOUNDJIGHI
CORDE d'un panier :      LEWBI
CORPS : MIOUTOU
CORRIGER  :    VANGA
ETRE A COTE : U BA PANGA
COTE  : LEBENDJI
COTE  : PANGA  
COTE  : NGOULOU
COTES  : MBENDJI
COU   : LEKINGA
COUCHE  :  KEKELI
COUDE :  MBOKOULO
COUDRE : NAMOUGHA  
COULER LES LARMES :     TSOLO     
COULEUR : PITA
COUPER : KESSE     
COURAGEUX   :  MOUTEMA LEKAMA
COURGE : NDZAKA
COURT  : BOUTELE BOUKOUBI
IL EST COURT   :  MOUKOUBI
COUSSINET :     IPOUNDILI
COUTEAU : MBEDI
COUTEAUX :     MAMBEDI
COUTUME : IKOU
COUTUMES  :   BIKOU
COUVER  : GHODOUNOU  
COUVERCLE   :  TAPA
COUVRIR : DJIGOUGHA  
CRACHAT : LATE
CRACHAT : IKOSSOLO
CRACHATS   :   MATE
CRACHATS    :  BIKOSSOLO
CRACHER : TOUTOULOU  LATE
CRAIE  : LVEMBE
CRAINDRE  :   MONO  BOMO
LA CRAINTE QUE J'AI   :   BOMO BOU ME LI NA BWO
CRAPAUD    :  IVOUGHOU
CRAQUER : GHASSANA  
CREUSER : VAKA   
CREVETTE :     MOUKOSSO
CRI  : LEKIMA
CRIER : KAYA     
CRIQUET   :   LEBANGA
CRIQUETS   :  MABANGA
CRIS  : MAKIMA
CROCHET   :    LENGOBIKI
CROCODILE  :  NGANDA
CROCODILES  : BANGANDA
CROIRE : CHINGA  
FAIRE CROIRE  : CHINGASSA     
CROISER LES BRAS  :   FOUTOU   CHA MIOGHO
CRU  :  CHI IBISSA
CRUCHE EN TERRE  :   MOUNIOMI
CRUCHES EN TERRE  :   MINIOMI
CUEILLIR      T0LO 
CUILLERE : MOUSSEBE
GRANDE CUILLERE   :  DOUDOU
CUIRE   : VIADOUSSA  
FAIRE CUIRE DANS UN PAQUET : YOSSO     
CUISSE  : INAMA
CUIT  :   VIADA
CUVETTE : LEPELA
CUVETTE  : ITENGUE CHI INENI
DABA :   IKANGA
DABAS  : BIKANGA
DAME   : MOUKASSA
DAME-JEANNE :   INGAMBA
DANSER : KENA
DANSER TOUTE LA NUIT :  KENA  MOUBEKA
DARD  :  MOUKOMBA
DE : A 
DE L'AUTRE COTE : NGOULOU YENA
SE DEBATTRE   :    POPA 
DEBILITE : FOUSSOU
DEBOUT! :  TEMOUNE!
ETRE DEBOUT   :      BA TEMOUNE
DEBROUILLE-TOI! : PAPADA    !
DEBROUILLE-TOI! : PAPADANGA  !
DEBBROUSSER par les femmes : SAGHALA      
DEBBROUSSER par les hommes :   SOLO  
DEBBROUSSER LA PLANTATION :  SOLO   NIOUNGUI
DEBUT   :   LEBABDA
DECEDER :   KWA
DECHETS  :  BIMBA
DECHIRER :   KASSALA      
DECOUPER  : KESSE  
DECOUVRIR :   KOUIDOULOU   
DEDANS    : TCHINA
DEDANS :  OUTSO
DEFAIRE :    NIANGOULA
DEFONCER  : PANDOULA
DEHORS   :  GHOU MBEDI
DEJEUNER  :  NDJA  
PRENDRE LE PETIT DEJEUNER :   TSOKO   CHA KOKOLO
DELIER   :  NIANGOULA
DEMAIN :    MBEDI
APRES - DEMAIN :   MBISSA MBEDI
DEMANDER :    VONDO  
DEMANDER DES COMPTES : VONDO   CHA MISSAMA
DEMANDEUR : MOU     BONDI
DEMANGEAISON :     TSOTSO
DEMENAGER : TODA 
DENT : NDJINA
DENTS :  MINA
DEPART   :  MWENDA
DEPASSER  : LOTA  
SE DEPECHER  :   SA  NA MOUKASSA
DEPENSER  : KABA  
DEPIAUTER   :  MASSA IBABDA
DEPLACER QUELQUE CHOSE   :   TSOKOUSSA    
DEPLIER : NIANGALA
DEPOSER : SOSSA
DEPUIS  :    A MATA
DEPUIS LE TEMPS QUE : MOU BANDA LETSOUGHOULI
DEPUIS QUE :    MOU BANDA
DERACINER :      LATA 
DESCENDRE :    KOUNANA 
DESCENDRE A :    YENDE GHOU
DESCENDRE A LIBREVILLE :   BANDA  LIBREVILLE
DESCENTE :     LOKANA CHIA
DESCENTE   :  MOUKOUDI
SE DESHABILLER :   KOLA 
DESOBEIR : LENGUESSE   
DESOBEIR   :   SA  MADZANGA
DESSEIN     : LEBEGHI
SE DETENDRE   : MONOGHO
DETENDRE     :    NANOUNA
DETRUIRE      TSAMOUNA   
DETRUIT : TSAMOUNA
DETTE  :  IBIMBA
DETTE  :    MOUGHANOU
DEUX   : BIOLI
DEUX CENTS  :  MIKAMA MIOLA
DEUX FOIS   :   BIOLI
DEUXIEME     :  BIOLI
DEVANT : YA BOUSSOU BWA
DEVENIR :     YA 
DEVENIR : KALAGHA    
DIALOGUE  :  LEVOVO
DIARHÉE :     MOUSSOUBAGHA
DIEU  : NZEMBI
DIEU :   MANONDZO
DIFFERENT    DE  :   YA SANDZA NA
DIFFERENT    DE  :   KIMA   
DIGNITE    :  LEGHOBO
DIGNITE    :  BOUYIMBA
DIRE LE NOM : TOUBA    
DIRECTEMENT : TE   GHOU 
DISCIPLE   :  MOUYIGHI
DISPARAITRE : NIONGO 
DISPARAITRE : NIAMBOUNA
SE DISPUTER :  VOVO   
DISTANCE  : IYENDE
DISTANCE  : PENGUIDI
DIVISER    :      KABA   
DIVISER   :    TSOKO   
SEMER LA ZIZANIE : TSOKO
DIX  : LEKOUMI
DIX-HUITIEME : CHA LEKOUMI    NA POMBO
DIX-NEUVIEME :  CHA LEKOUMI    NA VA
DIX-SEPTIEME : CHA LEKOUMI    NA TSAMBA
DIXIEME    :  LIKOUMI
DOIGT : MOULEMBA
DOIGTS  : MILEMBA
DONNER : VE 
DONNER DES COUPS DE BATON :   BOLA  BAKONDO
DONNER DES COUPSDE POING  : BOLA   BIGHABA
DONNER LA HONTE :   SA  TSOGNI
DONENER RAISON  : BENGASSA  
DONNER TORT :  BOMA  CHIA ISSALA
DORMIR : BONDOUNA  
DOS  : MBISSA
DOT  : MAFWA
DOUCEMENT     :     NA KOUNDOU
DOUCEMENT     :    BOUKE-BOUKE!
DOUCEMENT     :  NA BOUTSOGHA
DOUCEUR     :  BOUBWEDI
DOUCÉUR    :   KOLO
DOUCEUR    :    BOUTSOGHA
DOUCEUR    : SONDO
DOULEUR MORALE   :  NGUENGUI
DOULEUR PHYSIQUE  :  BOUKEGNI
DOULEURS D'ACCOUCHEMENT  :  MISSONGO
DOULEURS MORALES  :  MANGUENGUI
DOUXIEME   :  CHA LEKOUMI  NA BIOLI
DRAGUER   :  TE 
SE DRESSER    : CHIMBOUGHA    
DRESSER LA TABLE  :  VANGA      
A DROITE    :    MBAGHALA
LA DROITE   :    NGOULA MBAGHALA
DUREE : TANGA
DUREE D'UNE ACTION  : IDJINGA 
EAU  : MAMBA
EAU QUI BOUE : MAMBA MA MA TOGHO
EBENE : IVINDOU
ECHELLE  :   INEGHILI
ECLAIR    :  MOUVEDIAVEDI
ECOUTER   :  YOGHOULA    
ECRASER   :  GNIGHA    
ECRIRE    :  TENDE      
ECRITURE  :   LETENDE
EFFACER    : DJIMOUSSA
S'EFFACER    :  DJIMA      
EGOISME :     BOUKOUSSOU
ELARGIR  :   GNETOULE    
ELEPHANT  :  NDZOKA
ELEVEMENT :   LEKOMOUSSA
EMBUSCADE  : IDIKOU
EXBUSCADES : BIDIKOU
EMPECHER   : LEGHA      
EMPLOYEUR  : KOUMOU
EMPORTER   :  BETA     
EMPRUNTER  : SOMBO      
EMPRUNTEUR  : MOUSSOMBICHI
EN L'AIR    : GHOU YOULOU
EN PLEIN JOUR : NA NIANGA
EN PUBLIC   :  YA MISSA MIA BATA
ENCORE RIEN :  KI CHELA VE
ENDURER :      MONO  PAGHA
ENFANCE    :  BOUNGUEBE
ENFANT : MWANA
ENFANT TERRIBLE    : LEVAMBA
ENFANTER   :  BOTA     
ENFANTS   :   BANA
ENFANTS TERRIBLES :  MAVAMBA
ENFLER : RANDOUNA 
S'ENFLER    :   RANDA    
ENFONCER    : TSOUKOULOU    
ENLEVER    :  MASSA     
ENLEVER    : POSSA    
ENNEMI : MOUBOGHO
ENROULER  :   POTO 
ENSEIGNANT :  MOU YIGHICHI
S'ENTETER   :   SA  BOUDOUNDA
ENTIER : CHI IBIMBA
ENTIEREMENT  : CHI OUTCHI
ENTIEREMENT  : MBA-TSE 
ENTIEREMENT  : CHIOSSI
ENTIEREMENT  CHI IBIKBA
ENTIERS    :  BIMBI     
ENTOURER    : DJINGA     
ENTRE! : GNINGOULA !
ENTRE  : YA PENGUIDI
ENTREE DU VILLAGE :  TSOMBO BOLA
ENTRER : GNINGOULA 
ENVELOPPER :  KOTA     
S'ENVELOPPER  :  KOUBA LENGOYI
ENVIRON   :  BELE NA
ENVIRON  :   MFwEGHI
S'EPANOUIR  : PANDOUGHA 
EPARPILLER  :  GNETOUSSE 
S'EPARPILLER :   GNETOUGHE 
EPAULE : IKOUKOU
EPHEMERE    : LETSOUGHOU LEMOCHI
EPHEMERE    :     TCHIMBA
EPIDEMIE     : IVONGO
EPILER : DOUSSOULOU
EPILER : DOUSSALA 
EPOUSES : BAKEDI
EPOUSSETER  :  KOBOULA MOUFOUNDOU
EPREUVE     :  MVOUDI
EPROUVER DE LA JOIE : MONO GNINGA
ERREUR : ILEBA
ESCLAVE : MOUVEGHA
ESPERER   :   SA MOUTEMA 
ESPERER   :   SA SITOU
ESPERER   :   SA TSONGO
ESPOIR   : TSONGO
ESPRIT   :     LETENGUE
ESPRIT   :     LENIOGNI
ESPRIT   : BOUYEDI
ESPRIT   :      MOUKOUYI
ESPRITS   :    MATENGUE
ESSUYER   : GHOKOULO 
ESTOMAC :   IFOUNDOU
ETABLE : IVANGA
ETEINDRE  :   DJIMOUSSA
S'ETEINDRE :     DJIMA  
ETENDRE    :  SOKALA
ETENDUE :  ITETELE
ETERNUER  :   SA  BATCHE
ETIRER :  NONOUSSA
S'ETIRER  :   NONOGHO    
ETOILE : MVOULILI
ETOILES  :    BAMVOULILI
ETRE ETONNE  : KEMOGHA   
S'ETONNER : KEMA
ETOUFFER   :   IKIBA      
ETRANGER :     NDJINDZA
ETRE  : BA   
ETRE A COTE DE  :    BA YA PANGA A
ETRE ACCABLE : YILA 
ETRE   ALLUME   :   NAMA 
S'ETRE   ALLUME : YA NAMA
ETRE   AVEUGLE   :   WA VELA MISSA
ETRE   COLLE : KATOUNA   
ETRE   D'ACCORD  :   CHINGA      
ETRE   D'ACCORD  :  YAGHALA   
ETRE EN BONNE SANTE : BA BOUBWE
ETRE ENFERMÉ    :  BA BENDA
ETRE FERME :  BA BENDA
ETRE FORT : LI  NAPINDZA
ETRE GONFLE : BIMBA      
ETRE POURRI : CHI YA BOLE
ETUI POUR COUTEAU :  ISSOUPOU
S'EVANOUIR :  KWADA  CHA NIAMBA
EVANOUISSEMENT   : NIAMBA  
EVITER  : BAKALA 
EXPLIQUER : VANGA LELE
EXPLORATEUR  :   MOUKOTI
EXPLORER  : KOTO   
EXPRES    :   MOUTEBA
EXTRAIRE   : POSSA 




    FABLE    LESSABA
KAKBAGHA 
    FACHER      (SE -)
KA1ŒOUGHA    
    FACHER      (SE -)

    FADE     PODI

    FAIBLE   VOLO

    FAIBLESSEKOLa

    FAIM      NDZALA

SADA     
    FAIRE
(agir)SA     
    FAIRE
BOTESSA 
    FAIRE ACCOUCHER
LOUTA  MOUGHOUDOU
    FAIRE ALLUSION
NIODOSSO    
    FAIRE BOIRE
LEKE     
    FAIRE CHAUFFER

    FAIRE CONFIANCE SA      MOU TEMA

    FAIRE CONFIANCE SA  CHIA CHITA

SA      TSONGO
    FAIRE CONFIANCE


    - 44-





FAIRE    CONNAISSANCE      YABOUSSA   

FAIRE    CREUSER    TOUXA VAKA

FAIRE    CROIRE     CHINGaSSA   

FAIRE CUIRE  LAJœA

FAIRE DU COMMERCE   SOKBOUSSA   

FAIRE    FONDRE     SOlfOUSSA  


FAIRE    FO~lJ~f    SOLA

FAIRE    GONFLER    RAI'DOUSSA

FAIRE    GRI!lCER   GHWEKESSE   

FAIRE L'APPELTE 

FAIRE XONTER QUELQU'UN     KOKOUSSA   

FAIRE PEUR   SA  BOMO

FAIRE PLEUVOIR      :rOGHOUSSO  Cu)

FAIRE RASSEMBLER    KOKOUSSA   

FAIRE REXPLIRLOLOUSSA   

    FWAlfOUSSA  
FAIRE RESSEMBLER

FAIRE SIGNE  VESSE

FAIRE TOMBER RAGHASSA   

    DJE!lGUESSE      
FAIRE TOURNER

FAXILLE      :tlGAGHA


FAXIliE      IPENGA

FANTODXOUKOUYI

FANTOMBS     XIKOUYI

FATIGUE      ROKO

FATIGUE EXTREKE      DZOUGHOU

FATIGUER QUELQU'UN   ROKOUSSO   KOUTOU

FAUX   XALA
FELICITATIONS XALOUXBI

FEMININ     (FEMELLE)MOUKEDI
FEMKE MARIEE  MOUKASSA  OU BA KWELE

- 45-





FEMME    MAR lBE     MOUKEDI

FEMME QUI ALLAITE    MOUKASSA  WOUVE HAFELE

FEMMES MARIEES      BAKEDI

FENDREPASSA      <u>

FENDRE    UN ARBRE' PASSA       MOUTI

FERMEMENT     <moralement) KOUTEMA LEKAMA

FERMEMENT    (physiquement)KAKOU

FERMERDJIBOtTGHA  


FERMER    (SE -)    INDJ    l BIGHI      


FERMETURE    IBINDILI

FERTILELEBOLO
FESSE  LETAGHA
FESSES MATAGHA
FETICHENDJOBI

FETICHENGOYI

FETICHEILONGO

FETICHES      BILONGO

FEU    MBWAGHA

FEUILLELEKAYA

FEUILLE DE CAHIER    PEPI
FEUILLE DE PAPIER    ISSANGANGOUBOfJ

FEUILLES      MAKAYA

FEUILLES D'ARBRES    MAKA Y A :MA !-!OT}TI

FIANCE MBAKA
FIANCESBAMBAKA
FIDELITE      TCHIM!
FIDELITES     MATCHIMI
FIGURE PANDZA
FIL   (d'un   Coute6U)      MENGUE
FILAIRETSOSSO

46 -





FILET DE CHASSE      LICHINGA
FILET DE PECHELERIKI
FINIR     <intransitif)     FYlA    


FINIR     (transitif)MANA     

FLACON TSEDI
FLACON IPONGA
FLATTERIE     IPELE
FLATTERIE     DEDE
FLATTEUR      NGAIPELE
FLECHE LEBECHI
FLECHESMBECHI
FLECHIRIBONDOUNA    
FLECHIR     (courber à terre)      DENGUENE

FLEUR    (comes~ible    en brousse)KOUMOU
FOLIE  BOULEDI
FONTAINE      LaTEGHALA
FORCE PHYSIQUEPINDZA
FORCER QUELQUE    CHOSE     SA  PENDZA
FORET LOINTAINE      KOUKEI
FORET VIERGE  PINDI
FORGER TSCULOU

FORGERON      MOUTSOULI
FOU    GALEDI
FOU GUERI     MOULELEDI
FOUDRE KEKI
FOULE  KOUKOUNGUI
FOURCHETTE    MOUTSOUMOU
FOURCHETTE    MOUCHEBEA TSATSA
FOUROU NENGUE
FOUROU IFOUDI

    -4 r(-





FOUROUS BIFOUDI
FOUROUS BANBllGUE

FOYER     (bois du -) IBIKI

FRANCE  FWALA

FRERE     (frère/soeur)      NDOUMI

FRERES     (frères/soeurs)   BANDOUMI

FUIR    BATA    

FUMER   DOUTOU      CHA IVOLO

    FUMER    NIODO     

    FUMIER   LEBOUMBOU

    FURONCLE LOUSSOSSO

    FUSIL    llDJEDI

    FUSILS   MANDJEDI




....................




-   48   .-





GABON    <ouest)     POUNGOU

GABONAIS     (les -) MOUSSIPOUNGOU

GAGNANT     (le -)   MOUBEGHI

GAGNER BAGHA     


GARCON LEBAGHOULA

GARDE    (sentinelle)MOUKELI

GARDER KELE 

GASPILLAGE    BEYISSA

GASPILLE     (ETRE -)YA BOUNGANA

GASPILLER     BONGA     

GAUCHE     <A LA    -   DE) GHOU KASSA

GAUCHE     <la -)    :rlGOULA KASSA

GAZELLECHETI

GENCIVEBOUBITA

GENCIVES      MABITA

GE1IDARKE     MOUGHOLI

GENEROSITE    BOUKEBI

GENEROSITE    LEKABOU

GENOU  LEBONGO

GENOUX MABONGO

GENRE  LEKAKA

GENRE ANIMAL  LEKAKA LA BANIAKA

GENRE HUMAIN  LEKAKA LA BATA

GIBIER NIAMA

GIBIER DEPECE IKAKOU

GIBIER TUE    BIBETE

GIBIERSBANIAMA

GIFFLERBOLA  LEBOTO

GLISSADE      MFWELILI

GLISSERSENEGHE  


    -49   -





    GLUE  BOtTLIMBA

    GOBELET      KOPO

    GODASSES     BADROUMa

    GONFLE     (ETRE -) BIMBA    

    GORGE MOUNGONGA

    GORILLE      NDJIYA

    GOURMAND     <nourriture)  :N'GOUSSOU

    GOURMAND     <pour tout)   NGA KOUDOUKOU

    GOUTERJŒGHA    

    GOUTTELETEIlGUI

..GOUTTE A GOUTTE    LETENGUI-LETENGUI

    GOUTTE A GOUTTE     DOU-DOU-DOU

    GOUTTE DE SANG      LETENGUI      LA NGUINA

    GOUTTES DE SANG     MATENGUI      MA NGUINA

    GRAINELEBOUTOU

    GRAINE D'OSEILLE    KONGA

    GRAINES      MBOUTOU

    GRAINES    DE PIMENTBANDOUNGOU

    GRAISSE      HEDI

    GRAND BOUNENI

    GRAND LENENI

    GRAND     (- VILLAGE)      BOLA BOU BOUNENI

    GRAND (ANIMAL -)    NIAY~    OU MOUNENI

    GRAND     (HOMME -) MOUTOUOU MOUNENI

    GRAND     (le -)    NGWAMOUTOU

    GRAND-PARENT KAGHA
    GRANDE     (- JAMBE)LETEMBILE LENENI

    GRANDE     (- MAISON)      r;DZO    l INENI

BOGHA     
    GRANDIR

    GRANDS     (les -)  EANGWABATA

-50-





G RAIlDS-   PARENTS    BAKAGHA
GRATTER  GHATA  

GRAVIR      (une montagne)    BENDAGHA     Cu) (a moukoudi>
GRIFFE   NIADA
GRILLE      <part. passé)    KANGA
GRILLER KA!lGA  

GRILLON NDJENE
GRI:M.ACES      BISSA:MOUNA

GRINCER  GHWEKE   
GRIOT    KOUTSOUNDI
GRQGNER  CHINGOULA      Cu)
GROGNER<= cochon)      BEMBE 

GRONDER  SEJœE 

GRONDER(= tonnerre)    DOUKA      Cu)
GROS     BOUNENI
GROSSESSENA DlIMI
GROSSIR(se gonfler)    RANDOUNA      
GROUPER  KOKaSSA   

GUEPE    ILOUBI
GUERI (ETRE -)  BELEGHE  Cu)
GUERIR   BELESSE  Cu)
GUERIR<intransitif)    BELEGHA
GUERISSEUR      KOUBELICHI
GUERISSEUR      NGA~!GA

GUERISSEUR<CONSULTER LE -)    MONO          NGANGA

GUERRIER MOUL\rlENI

GUETTER  DOKO     

GUETTEUR HOUDOKI

GUEULE   MOUNIO

GUIDE     (: ccnducteür)      J~OUBITI

1 -
~:,





GUIDERBETA     Cu)

GUITARE      NGOXBI




....................




HABILLER     LWATA     

HABILLER     (s. -) LWATOUSSA   <u)

    LWATOUSSA   
HABILLER ÇUELQU'UN

HABITANT    DE      MaUSSI BOLA

HABITANTSDE  BISSI BOLA

HABITANTSDE  BAT A   BA

HABITUDE     IKOU
HABITUDES    BIKOU
HACHE PIBI
HACHESMAPIBI
HAlliELEVIDA
HAINE IBENE
HAIR  VIDA 

HAXECON      LELOBO

HASARD     (PAR -)  MOU MATESSELE

    TSOPA 
HATER    (SE -)

    LENGUESSE   
HATER    (SE -)

HAUT (EN -)  GHOU YOULOU

HAUTE    VOIX    (A -)     GHOU KETIA YOULOU

HELICOPTERE  LAVION LA INGAMBA

HERBE CHIMBA

-52-





HERBES   BIKBA
HERBIVOREMOUNDJI A BIKBA
HERISSON  ICHEKE
HERITAGE  KOUKVEGrrI

HESITER   TCHIKOUlfA 

HEURE     LETEDI
HEURE (QUELLE      -   AVEZ   VOUS   ?)      WE LETEDI KANA?
HEURTER   KOBA      

HEURTER UN OBSTACLE     KOBA       LI BA KA

HIER      KBEDAJTGUI ){BEDI

HOCHER LA TETE   TSOKOUSSA   MOUTSWE
HOMJŒ     KOUTOU
HOMME DEBAUCHE   MOUTA BOUPoUPOULoU
HOMJŒ DEBAUCHE   KOU TOU A BOUPOUPOULOU
HOJOtE SOTMOUTOU INDJILI
HOMMES    BATOU
HOMMES      (= les males)      BA BAGHALA
HOJOtES D'AUTREFOIS     BATOU BA KALA
HOMMES DE BAT A    BA

HONORER   GHOBOSSO  
HONTE     TSOGNI
HOQUET    ITSOKIATSOKI
HOTTE     PONDJI
HUILE     KEDI
HUIT      POMBO
HUITIEME  MOUPOHBO
HYPOCRISIELEVEDI
HYPOCRITE NGA     LEVEDI




- 53-





ICI  YA

ICI    ET LA}I..BEDI A KBEDI

IDEE OUTASSA

IGNAME      MBAl!

IGNAMES     BAMBALA

IGNORER     SA  YABA VE

IL   N'DE

IL    Y AURAA KA BA

IL    Y AURA UNE PLUIE    A KA BA NA      MVOULOU
IL    Y AVAIT      A BA
ILE  IROKBA
ILE  NDOUBI
IMAGEINDJIMA
IMITER      YEGHOULE      

!KPORTUNER QUELQU'UN      YOUNGaSSA       MOUTOU

IMPOTLEPA

INCLINER    BANDOUSSA      

INCLINER <S'   -)  DENGOUNE      

INCONNU     (substantif)  NDJINDZA

INCULPER    KOU TOUL OU    

INDEX (= à coté du doig~ principal)KOULEMBA    A DOUKA NA NGOU

INDICE     <signe) ILEMBA

    INDIGESTIONLEYOTOUGHA

    INDISCIPLINE  (adj.)     NGAMANDZANGA

    INDISCIPLINE   <substantif)     MANDZANGA

    INDISCIPLINE   (substantif)     IVOULOU
    INFIRME    !KATA
    INFIRMES   BIKATA
GflENGOUSSA  (ü)
    INITIER(= faire .ntTEr1

    INJURE      ITCUGHI

- ~)4-





INJURIER QUELQU'UN    TOGHA      CHIA MOUrOD

INNOCENCE      NI MABINGA

INNOCENTMABINGA

INNOCENTWA VELNADJAMBA

INONDATION     TONDA

INSCRIRETENDE     

INSCRIRE   (faire    -)      TENDOUSSE 

TSAGHOUSSA  
INSTALLER

INSTALLER <s.   -)    TSAGHALA

INSTRUMENT   POUR SCULPTER   PAKA
TOGHaNA      
IllSULTER

INTELLIGENCE   BOUYEDI

INTELLIGENT    IYEDI

INTENTION      KENDZA

LEGHA     
l 11TERD   l RE

INTERDIT   <UN -)     NGtTIDI

INTERIEUR      aUTSO KETI

Il1TERPRETER   MOUYOUKILI

YOKaLA     
INTERPRETER

FOULOU     
INTERROGER

GNI      NGASSA
INTRODUIRE

IVRESSE WA KOLa MALA

IVROGNE KOUROKI      !{ALA

IVROGNE MOUROKI      MALAMOU



    ....................




- ~5-





    JALOtlSIE  KOlJNOU

    JALOUX(substantif)NGAKOUNOU

    JAMBE      LETEMBI

    JAXBES     KATEHBI

    JAUNE      YA BENGUE

    JE  JŒ

    JE SUIS    ME LI
    JETER      VEDE    

    JETER      BOUSSOU  

    JETER    <A LA MAIN)     TETE    

    JETER AU LOIN     BOUSSOU   VALA

    JETER UN SORT     LOGHO     (ü)

    JETEUR DE SORTS   MOULOGHI

    JEUNE    FILLE      (= célibat3ire)    MOUKASSA VA VE KWELE

    JEUNER     MINA     CHA KOUGHI

    JEUNESSE(= enfance)      BOUNGUEBE

    JEUXMITAMBA

    JOUELEBOKA

    JOUER      TAMBA     

    JOUES      MABOKA

    JOUR SE COUCHE  <le -)   BOUCHI     BOUYILA

    JOUR    SE   LEVE    <le -)     BOUCHI     BOUKIA

    JOURNEE<TOUTE LA -)      LETSOUGHOU     LA BOUCHI

    JOURS (TOUS LES -)BOUCHI     NA BOUCHI

    JUGEBANDZA

    JUGE (palabres)   MOUKECHI

    JUGEMENTS  MIPAKOU

    JUGER      PAGHALA  

    JUGER      SONGOUSSA  Cu)

    JUGER      KESSE     


- 56-





BABAlfDZA
JUGES

JUJŒAU LEVASSA

JUMELLELBVASSA

LABA     
JURER

JUSQU'ANGUIOIlA


JUSQU'A AUJOURD'HUI  TEll A LOLO


JUSQU'AU SOIR TENA    :MOUKOLO

JUSTE    <.= bien)   BWEDI

JUSTE     (= suffisant)     TCHITSA




    ....................




LA-BAS GHD NA

LA-BAS YA NA

LAC    DJAllGA

LACETS (= piège)      LDUSWE

NIAliGASSA   
LAISSER
NIAGHA 
LAISSER
KABElfA:MA TABA
LAIT DE CHEVRE
LAMPE  LEPI

LANGAGENDAGHA

LANGUE (= organe)    LILIKI

LARGE  BOUNENI

LARXES KATSANGA

TSOKA  
LAVER
YOBO
LAVER    (SE -)
VETE
LECHER
LEGER  CHA LENGUE

- 57-





    LEFRE   KAKEDI
    LEVER (SE -)   TEMOUNE


    LEVRES  BIBODI
    !..EZARDICHILI
    L ! A~;ELEEAMBA
    LIANE   NDANGA
    LIANECAOUTCHOUCNDAMBA
    LIBELLULE      NG\tlANAGUEGNI

    LIBERER POTOLO

    LIEN (corde)   LENDJITA
    LIEN <corde)   MOUCHINGA
    LIE!l      <parenté)  MOUTCHIGHA
)
    L l EU     Cendrc-i   t      ITSEGHA
    LIE T} D' A I SAN CES TSOMO
    LIEUDE REPOS   MBOGHAI BOUVOMA
    :'!EU DE REPOS MBIJGHA VOMA

    LIEU SECRET    LOUSWE!)E

    LIEU SECRET    INDONGO
    LIGNEE (fawiliale)    ITSOUKOU
    LIMACE  ILONDJI
    LIMITE <SANS -)ITSIGHA
    LIMITE (SANS -)CHICHA VE NA MANDILA
    LIMITES MANDILA
    LIG!!   INGOUNGOU
    LIPE    T AIlGANA     

    LIT     TENGUI
    LIVRE   ISSANGA?1GOUBOU
    LONGER (une rivière)  GHONGOULO       (:1dzeli)

    LO!J'G UEUR    BOTJTELE

    LOUCHER (yeGx/état/tordus)   MISSAKIA     VENGOUGHA

58 -





LOUER    (= flatter) VEVaLE (iJ)

LOUER    (= religion)KOUXOUSSOU    

LOURD  BOULEXA
LOURDEUR      BOtTLEXA

LOURDEUR D'UNE CHOSE BOULEXA BWA CHE!..A

LUI SEUL      IDE BOUTOUBOU
LUI SEUL      NDE KWE
LUXIEREXBWAGHA

LUXIERE   (= jour)   BOUCHI

LUD    .GOIDI

LUIETTES    (= verre)BIEGI"I




....................




HACHETTE      KBEDI-ICOTO

XACHETTE      LEBATA

XACHETTE      ILETaLE

KACHETTES     KABATA

UCHETTES      KAKBEDI-MABlcoro

Y&ACHETTES    BILETaLE

JfLACH   l Ii CHELA

:MACHOIRE     MOU   BANGA


KACHOIRES     :MI BANG     A


MAGNANSBANGlTEy,rS   l

(
YU\IGRE  (ETRE   -)  GHASS AU r: A   -   '\




J'AÂIGRI    R GHASSA    (u'

MAIN   LEr:AK A


-- 59 --





XAI'BS   MAKAKA
KAINTENANT      NA   XAllDZ l

MAIS     (substantif>  POUTOU

MA ISO!l NDZO

MAISONS  KANDZO
MAITRB      (= enseignant)    :MOUYIGHICHI

MAL    (nom et adj.)   BOUBI

XALADB   KABBDA
XALADIB  MABEDA
MALADIB DU SOMXEIL     KABEDAKA CHOLO

XALADIF  KOUBEDA
    
MALADIF  (Btre dans un état -)KONOGHO

M.~LEDICTION    BOULOGHI

MALEDICTION     OUCHIBOULA

XALEDICTION     NDOGHO

XALBDICTIONS    KANDOGHO

MALEDICTIONS      (= mauvaises   paroles)   MABIGHA MA MABI

KALI Il (su bst      .   et   adj.>  BOUYEDI

XAKAN    KA KA

)[A.CHE (LA -)  GHOGHO

KA.CHB      <LE -)     :MOUTSOUDOU

KAJlCHE <LE -)  KOUVINIA

:KAllCHE DE COUTEAU    MOUBENDA

MANGER   NDJA

TSOKO  CHA KOKOLO
XAI'GER LE MATIN
:MANGUE  MOUMANGA

KANGUES  MlKANGA

)lANIERE LESSOGHA

:MANIERE MOUNONGO

XABIFESTATION   MOUBEKA

    - 60-





MANIFESTATION BRUYANTE      OUROUNGOU

MANIFESTATIONBRUYANTE      GHOUTOUXOU

:MANIFESTATIONS     KIBEKA

MANIOCXID.DRO
HANIOCPITA
XAIlIOC    (BATON   DE -)  IKYAlIGA

XAIlIOC (FEUILLE      DE -)XAYAGHA

MAllIOC PREPARE     LEBABDA LA PITA

MANIOCS      BAPITA
MANQUER      VELE     

KITOUSSA  
MANQUER     (= louper)
KITA     
MANQUER     (= louper)

MARATRE      PALA     IlGYA WE

PIllIA    
MARCHANDER

MARCHANDISES BITSADA

MARCHANDISES XABOKO

KARCHE !     TSYE !

MARCHE     (LA -)   XWEI'DE

MARCHE     (LE -)   LEKASSA

KARCHER      YElIDE

YiARI HOULOUXI

MARIAGELEKYELE

MARIER KWELE     

MARIER     (SE -)    KWELOUNE 

MARIGOTXOUDJAGHA

MARIGOTS      MIDJAGHA

MARMITENDZOUNGOU

MARQUE PITA

MARQl"ES      MAPITA

MASCULIN      LEBAGHALA

    - 61-





MASQUE D'AlllXAL    KVOUDI

HATlN !lA lIGWELI

XAUDIRE      LOGHO

Y~UDIT   (adj.)     WOU BALOGHO
XAUVAIS      BOUB    I
JŒCHAlfCETE  BOUKEGII

JŒCHAlfT     KECHI
JŒCHAIlT   (PAS -)   KECHIVB

JŒCHAIlT   (PAS -)   WA VELA     KECHI
MEDAILLE      XOUSSAIfGA

XBDECI.XCJlTBQUGHI

JŒDICAJŒJTT   KIT!
XEDICAJŒliT   ILOWGO
!ŒDICAJIŒ!lTS BI LOllGO

MERE<= grand-mère)   KAGHAOU KOUKASSA
)
XEIŒ(KO   I- XE XWElfE

JŒXOIRE      LEKELESSE
ME.ACESADA
JlŒllACE     LESSIGHALA
JŒJrACE      LEVOVO

Y.EflACE     XOUDJINGA
JŒ!lACE      KOUCHIBALA
JŒlISONGE    KALA
JŒNTEUR      NGA    KALA

JŒNTIRLELE      KALA

KENTONPENGUE
1ŒPRISER     KAMA      CHA MOUTEMA
MEPRISER     ROKOLO 


MEPRISER    QDELQU'UN      HOKOLO      NA    MOU TOU

LE:S~~tE LA ,lE


--62 -





JŒRE    NGOU

MESSAGE TSAllGA

1ŒSURE  CHETSE

MESURER YEBOUSSE      <u)

:METIER MOUDIANDZA

METTRE (= placer)     SOUSSA      

JŒTTRE A LA PORTE     FOUNDZA      <u)

METTRE D'ACCORDYAGHALA      

METTRE D'ACCORDCHINGA      

BATASSA      
METTRE EN FUITE
:KETTREEN TAS SA  MOU BIBOUTOU

MIDI   LETEDI LEKA KETI A KETI

KIDI   KOUTEJlL4   NIArlGA


:KIDI  MOUTEMA BA BOUCHI

MIEL   BOUYI

MIETTE MATSETSENGUI

MIETTESFOURFOUCHI

MIETTES   DE PAIN'   MATSETSENGUI     MA PEMBE

MILIEU KETI

MILIEU    (AU -)     YA KOUTEKA

MILITAIRE     MOUGHOLI

MILLE  MOUTOSSINA

MILLE  MIKAMA LEKOUMI

MILLE FRANCS  KIKAKA      MIOLI

MILLE-PATTES  NGONGOULO

MIRACLE IMOULOU

MIRACLE IMAGHA

MIROIR CHEGNI

MIROIRS EIEGNI

GHOBaCHI  
MODESTE     (EIRE   -)

--63 -





MOI   ME

MOINS PESSA

MOINS BON    FESSA BOUBWE

MOITIEIBEDI

HaLLETMOUVINDI

MOMENT     <AU MEJtf.E -)  YA KETIA YA

MONTAGNE     KOUKOUDI

:MONTER      KOKA     

MONTERVATA     

MONTER     A   BRAZAVILLE  TANDA      BRAZAVILLE

MONTER AU-DESSUS    KaMA      OU YOULA

MONTRER      KWESSE     

MONTRER      LAGHA     Cu)

MOQUER     <SE -)   VELE     Cu)

MORDREKAGHA     

MORT    (HOMJŒ      -)     MOUTOU     A KWA

MORT    SlTBITE     LEBIMBI

MORT-NE      BA BOT A A KWA

MORTIER      MBOUNGOU

MOTIF     (cause)   TSOTSO
HOU   YA KOLO

MOUCHE TSE-TSE      BOSSO

MOUCHE TSE-TSEIVIVI

MOUILLER     BOLO     

XOURIRKWADA      

XOUSTIQUE    TOUBOU

:MOUTONTABA

HaYEN  TSONGO

MOYEN     (PAS -)    TSONGO    VE

IBEBE

- 64-





MULTIPLIER     BWESSE      

MUR     IBAGHA
)(UR     <ETRE     -) YA YELE
MURIR   BENGUESSE  

MURIR (= noir, bleu)  PINDA      

MURMURERWADaNA      

MYOPE   TENDI
MYOPES  BATENDI



....................




NAISSANCELEBOTA
NAVETTE  LOTO LA LaSSO BA BATA

NAVETTE  (FAIRE  LA -) KIBA 

NE PAS. ..   (pluriel) NIAGHA     GNI.   ..

    )
NE      PAS.   ..   (s i ngu    11 e r      ?lIAGHA

NEANT    CHELA VE

NEGOCIATEUR     MOUBONDI

NET      YA SONGOUNA
NETTOYER TSEMaSSE      

NETTOYER LA PLANTATION SAGHALA      NIOUNGUI

NEUF (adj.)     CHELA CHA NA MANDZA

NEUF (nombre)   VIA

NEUVIEME VIA

NEZ      LEYOULOU

NOEUD    LENDJITA

NOIR (= couleur)MOUPINDI
    - 65-





    NOIR (=r::ice) MOUNOMBI

    NOIRCIR PINDOUSSA

    NOIRS (= raçe) MINOMBI

    NOM     KOtTMBOU

    NOMBRE  MOUTALA

    NOMBRE  LERAMBOTJ

    NOMJŒR  LOGHA     KOUY~OU

    NOMMER  VE  KOUMBOU

    NON     AGHA

    NOTABLE IVONDA

    NOURRIR BONGOULA    

    IiOURR    l TURES     BIELA

    NOUS    FESSA

    NOUVEAU (adj.) ~TAMANDZA

    110UVEA    U - NE     IKEGNI    CRA   M\JAUA

    NOUVEAU-NE     IKEGNI

    NOUVELLE     (nom)    MOUKENDA

    NOUVELLES     (substantif)   MATSANGA

    NOYAU   MOUNGUI

    ~ruAGE  LEBOUNGUI

    NUAGES  MABCUNGUI

    NUDITE  MOUNIENGUE

    NUIT    BOUTSOUGHOU




    ....................




    -'
66   -






OBEIR    YIHEOUSSA

OBEISSANCE      LEGliOBOUSSO

PINDOtTSSA     
OBSCURCIR    <SI -)

OISEAU  IFOUDOU

OISEAUX BIFOUDOU

OMOPLATELaPAPANGA

ONGLE   NIADA

ONGLES  MANIADA

ONZE    LEKOUMI NA CI>MO

OREILLE LETCHVlI


OREILLESMATCHWI

ORGUEILLEUX    (FAIRE L'-)   SA  MADZANGA

ORTEIL  LENIADA

ORTEILS MANIADA

OS (pluriel)   MAVICHI

OS (singulier) LEVICHI

OUBLIER TAMBOUSSA      

OUI     È
OUVRE LA BOUCHEDJIBOULA     MOUNIO




....................




67





    PAGAIE  LaNGUEPI

    PAGAILLE      <SEMER LA -)   SA     MOUPOGHA

    PAGAYER DOUGHOU     

    PAGNE   TSANDA

    PAIEMENTXAFOUTOU

    PAILLE(sur la maison)  KONDZA

    PAIN     LEPEKBE

    PAINS    PENBE
    PAIX     POLO
    ::p
ALABREHOUSSOSSO

    PALABRE  NDJAKBA
    PALABRER SA  MISSOSSO

    PALABRES HISSOSSO

    PALAIS(de la bouche)   LELELAGHA

    PALE     DOUDOU

    PANIER(récoltes)PONDJI

    PANIER A PECHE(bambou, main)  MOUSSOMBA

    PABIER A PECHE(liane, dos)    MOUSSOUNDI

    PA!lSEJŒ_T      IRENDE

    PANTHERE VEVI

    PANTHERESBAVEVI

    PAPA     TEYI

    PAPAYE   LELOLO

    PAPILLON IFOUDOUNGANGA

    PAQUET   MOUKOTA

    PAR PITIEMOU    TING A

    PARAPLUIELEPOUNOOU

    PARASSOLIER     MOUSSENGUE

    PARASSOLIERS    MISSENGUE
    PARCE QUENOUE MOU

    - 66-





PARENTE     <subst.) :MOUTCHIGHA

PARFOISMAJŒGHAMA KE
PARFUM MOUYOXBO
PARI   IVIGHA
PARIER      (= faire un pari)      KESSE       IVIGHA

PARLE     (NE - PAS) l'IAGHA VOVO

PARLE     (NE - PAS) }fIA VOVO

PARLER A QUELQU'UN   TATA     CHA HOUTOU

PARLER BIEN   VOVO     BA BWEDI

PARLER FORT   CHIXBOULA   NDAGHA

PARLEURXOUVOVI

PARLEURS      BAVOVI

PARLEZ     (NE - PAS)llIAGHA GBI VOVO

PAROLE NDAGHA

PARTAGER      KABA    

PARTEZ!YE1fDE !

PARTIE SEXUELLE  (homme)    LEKATA

PARTIR YENDE      

PARTIR     (A - DE)  MOUBAliDA

PARTIR     (A - DU MATIW)   XOUBANDA  NGWELI

PAS DU TOUT   CHELA PESSA VE

PASSE    <LE CAMION     -)  LOTO    LO LOT A

PASSER LOTA    

PATATE DOUCE  IKONGO

PATATE DOUCE  DENGUE      (invariable)

PATATES DOUCESBI KONGO

PATE   LITOKI
PATIENTER     RE!ŒOUSSA  

PATIENTER     KELE    

PATTE  LEPALA

-69-





PATTES   Jt!APALA

PAUSE    VOJttA

PAUVRE COUILLON!ITOUKOU
PAYER    FOUTOU      Cu)
PAYS      TSEN'GUE
PEAU      IBANDA
PEAU DE BETE     l BA!\"DA

PEAU HUMAINE     MOU KOBO

PEIGNE    TSATSA
PEIGNER      (SE -)     TSATSA      

FEIIlDRE  NOGA     <u)
PELER      <intransitif)YOBOUGHA  

PELER    (transitif)    YOBOULA 

PENCHER      <SE -)     DENGUEIE  

PENDANT QUE      MOUKOULOU
PENDANT QUE      :MOUKOULOU WOU

PENDRE     (SE -)LELEGHE 
PENETRER  GNIGOULA  

PENSEE     (MAUVAISE -) TCHIXI YIBI
PENSER    TCHIMaNA  

PENSER    TASSA      

PERCER    TOUBOU      

PERCUTER  TELA     

PERDRE     <SE -)NIONGOUSSA    

PERDRE     <SE -}NIAMBOUNA  

PERDRIX   NGVlELI

PERE      TATA
PERROQUET KOUSSOU
PERSONNE <PAS  UNE -)   MOUTOU VE
FER2'ON~1E    (TJNE -)  MOUTOU

-- 'f 0 -





PERSONNE    CHERIEMOUTAME    wA MOUTEMA

PERSONNE    CHERIEMOUTOU A KE WA MOUTEMA

PERTE      NIONGO

PET MOUKOUCHI

PETIT      NGUEBE

PETITESSE(= jeunesse)    BOUNGUEBE

PETITESSE(taille) MOUKOUBI

PETSMIKOUCHI

PEU PESSA

PEU A PEU  PESSA NA FESSA

PEUPLE     LILONGO

PEUR    (FAIRE -) P AMOtTNA


PEUX TRES BIEN (TU -)    VESSA KûNDO VE

PIANIBENDE

PICORER  
    DOK'J

PIECE     (chambre)TCHINAND20

PIECE     (chambre)TCHINA A NDZO

PIED LETEKBI

PIED <AU     -   DE)      YA TCHINA    A

PIED D'UNE TABLE   TSODI

PIEDSMATEMBI

PIEDS D'UNE TABLE  MATSODI

PIEGEMOURAMBA

PIEGE     (à trou) TOULI

PIEGE     (noeud coulant) LEBANDA

PIEGE A OISEAUX   LENDEMBE

P:EGES     MIRAMBA

PIEGES    (à trou)BATOTJLI

PIEGES A OISEAUX  MANDEME.E

PIERRE     LEMAN lA

.
    --   71





PIERRE A BRIQUET LEKANIALA MOUKWETE

PIERRES   MAMANIA

PIGEON    LEKONDA

PILER     TOKO    



TOKO        BAPITA
PILER    LE MANIOC

PILON     MOUSSOU

PIKENT    NDOUNGOU

PIMENTS   BANDOUNGOU

VAKA    
PIOCHER

PIPE      CHINDZA

PIQUET    ISSOUMOU

P!QURE    TSONGUI

PIQURES   MATSONGUI

PIROGUE   MBOUNGOU

PISTE     NDZELA

PITIE     TINGA

PLACE    (A LA   -   DE)YA ITSEGHA   CHA

PLAIE     PINGUI

PLAIE    <SOIGNER UNE -)BOGHA     Cu) PINGUI

PLAINE    ILONGO

PLANCHE   MABAYA

PLANTATIONNIOUNGUI

PLANTATIONS      MANIOUNGUI

PLANTE VENENEUSE    (pour poissons)   YOULOU

PLANTER   KaNA    Cu)

PLAQUER   KATOUSSA

PLAQUER   KATOUNACu)

PLEIN     YA LOLA

PLEIN     (ETRE -)      CHA KOGHA

PLEIN JOURNA NIANGA


- 72





PLEURER  LELA    

PLEUREUR MOULILI

PLEUVOIR NOGHO     

NOGHOUCHI  
PLEUVOIR     (faire -)
GHODOUCHI  
PLIER

PLIER LES GENOUXGHODOUCHI   MABONGO

PLOYER   DENGUENE 

PLOYER     (FAIRE -)   DENGUESSE  

PLUIE    MVOULOU

PLUME    TSALA

PLUMER   FOUDOUGHOU    

PLUMES   MATSAlA

PLZTS    BOULEGHI BWA LOTaLA

PLUS RIENCHELA     KA    ,",-TE


?1fEU    GHOULOU

POIGNET  LEYOUKOU

POIL     MOUKOUNGOU

POILS    MIKOUNGOU

POING     IGHABA

POINGS   BIGHABA

POINT      (SUR LE   -   DE)  YA

POINTE DES PIEDS   (SUR LA -) MOU MATSOUMBITI

POISSON  TCH,..,I

POISSON     (salé)     MAKAYABA

POISSONS BATCH,..,I


POITRINE TOULOU

POLYGAMIEINGANDA

PORC     HOUBONO

PORC-EPICNGOMBA

PORTE    INDJIBOtJGHA


- '13-





PORTER    PLAINTE    sasso ('J   ';


PORTIONLEKABA
POSER  SOUSSOU     

POSER    SUR  TEMBA  GHOUYOULA

POSER    STJR TEMBA  GHOUYOULOU   A

POSSESSEUR    NGACHELA
POU    TCHINa
POUCE  MOULEMBA-NGOU
POUDRE DE CHASSE     MFOULOU
POULE   TSOUSSOU
POULS     (= p31pitation)    YI MA
POVLS     (= palpitation)    MOUTE:f\1A  T SOKA

POUMON  POUPOUDOU
POUMONS BAPOUPOUDOU
POUR QUETO
POURQUOI?      MOU KI ?
POURQUOI?      MOU EIKI ?
POURRI  YA BOLO
POURRIR BOL   0   (ll)


POURSUIVRE     TOTJTOUNOU

POUSSER TCHINDOUGHA   

POUSSER UN OBJET      TCHINDOUGHA   Cu) CHA CHELA
POUSSIERE      1'.:OUFOUNI)OTJ

POUVOIR     (PLUS -)  KCNDO Cu)
POUVOIR     <substantif)     LENIANGA
POUVOIR     (verbe)   TOGHALA     

POUVOIR     (verbe)   TGGHA 

PRECAUTIONNEUSEMENT   DENGUELE

PRECIPITER(SE -)      ROUNGOU     

PREFERERrONDO (\1)


-   7 t1





PREMIER 'viA TSOMI

PRENDRE BONt.:?O 

PRENDRE LA PAROLE     BONGO      CHA     NDAGHA

PREPARERVANGA     

PREPARER LES MEDICAMENTS     VANGA      CHA MIT!
PRES DE YA PANGA A
PRESENTATION   M'vIESSE


PRESSER KAMOUI1A 

PRESSER      (entre les mains)      PINTA     
PRET A PARTIR  BELE NA U YENDE
FRETER  NWANOUSSA


PRIER QUELQU'UNBONDO      CHA MOUTOU

FRIERE   LEBONDO
PRIS (ETRE -   SUR LE FAIT)   SOMa-GHA    (1.1)

PRISONNIER      NGATSOUGHOU

PRIX     LENDJI
PROCHES      (LES -)   BANGAGHA
PROCURER VEDE


PROCURER      A QUELQU'UN     VEDE CHA M00TOU

PROFONDEUR      MOUNIONGUI
PROFONDEUR      MOUYONGO

PROMENADEMOU GHENGUILI

PROMENER      (SE -)   KEMBA 

PROMESSE NDAGHA
PROMETTEEYAGHANA     N~AGHA

PRONONCERTATA

PROPRE   CHA TSEME
PROTEe.   TETJR MOUKELI
FROTEGER KALA


PROVERBE TSA-:-SAEA


7":)





    PROVOCATIONS  BISONGUI

    SaNGa   
    PROVOQUER

    PRUDENTBOUYEDI

    PUBLIC    <EN -}     YA MISSA MIA BAT A

    PUCE   KASSA

    PUCES  BAKASSA

    PUISSANCE     LENIANGA

    PUITS  LETEGHOULA

    PUNAISEIKFOUOOU

    .PUNIR KEGHaSSE      <u)

    PUPILLE     (UNE -)  NGUEGNI

    PUS    MAVINIA

    PYGMEE    <tri bue)  MOUBONGO

    PYTHON MEOMO




    ....................




- 76-





QUANT    'A MOIKOU KE
QUARANTIEJŒ    CHA XAKOUMI KANA

QUATORZIEJŒ    CHA LEKOUXI BA BINA

QUATRE  BINA
QUATRE CHOSES  BIELA BI.A

QUATRE HOJOŒS  BIWA    BATABAllA

QUATRIEXE      BIllA

QUELLE IMPORTANCE?    TONDI      l'A ?

QUELQU'UN      KOUTOU-'

QUELQUES     CASES    :MAllDZO    MAKE
QUE'LQUES    HOIOtES  BATA    BAKE

QUERELLER  <SE -)     LWA"A      

QUESTIONKBIGHA

QUESTION      XOUDOUGHOU

QUESTIONS     KAXBIGHA

QUI?   NA ?

QUINZIEME     CHA LEKOUMI NA BITANA

QUOI?  BIKI ?




....................




-77-





RACINE   MOUKENGUI
RACOKTEURMOULELI    A MAJI,:EA

RACONTEURMOUVOVI    A MAMBA
RADEAU   ILINDI
RADEAU   IPEGNI
RADEAUX  BILINDI
RADEAUX   BIPEGNI
RAIDIR      (SE -)      REMBOUGHA     

RAISON      (SANS -)    TOND! VE
RÀMER     DOUGHOU    
RAMPER    YENDECu) MOU LEBELI
RANC'\JNE PENDA
RANCUNE      (GARDER -) KELE      PENDA

RANCUIIIERNGAPENDA
RANGEE      (LA   - DE) MOULONGO    A BA
RANGEE      (une -)     MOULONGO
RAPIDEMENTMA YlASSA

RASOIR    LESSAMBA
RASSEMBLER <FAIRE -)    KOKaSSA    Cu)
RATPOUGHOU
RATER     KONDOCu)
RATS      BAPOUGH'JU

RAVIN     MBEIiGUE
RAVIT.~..ILLER   TOUMA(',J) BIELA

RAYONS      DU SO~EIL   MISONDJI    MIA LETEDI
RECHAUFFERTOCHILI    

RECHERCEERSAGHA


RECOLTER  TOLD     

RECOMPENSEISS'EKI
RECOMFEN~::ER    FOi) TO~.T ('.J)


--   78 -





RECONNAITRE  DJIGH3.LA  <u)

RECUPERER     BABONGO  

REDRESSER     CHIMBOULA   

REEL   MOU MBOULI

REFLECHIR     TASSANGA   

REFLECHIR     PANDZA

REFUS  LEBISSA

REFUSERBISSA      

REGARDER      TALA      

REGARDER      KENGOUSSE   

REGARDER     DE TRAVERS     DJIKaDA  (:..J)

REGIGN TSENGUE

REGLES    (menstruations)   IMERENDJI

REGLES ABONDANTES    IMBRENDJI   CHIA LOTaLA

REGLES DOULOUREUSES  IMBRENDJ!   TCHINAMOGNI     BCUKELI

REGLES FREQUENTES    IMBRENDJI   TSOU YOCHI

REGLES    IRREGULIERES      I~BRENDJI   MATSOGHOU     MAKE

REGLES PERTURBEES    IMBRENDJI   TSWA KaDA TS~A KaD!

REGLES PROLONGEES    IMBRENDJI   CHIA   ILEGHI

REGRET NGUE~GUI

REGRETTER     MONO       MANGDENGUI

REGRETTER     TCHIMA

REGROUPER     BA      1COKaSSA

REIN <bas du dos)    LENGOUNDOU

RELATIONS    SEXUELLES      BILEDI

REMERCIER     SA (ü) LEBYE LA MOUTOU

REMODELER     VANGA

REMPLACANT     <substantif) IKISSA

REMPLACANTS   BIKISSA

REMPLIRLOUSSACu)


    -rIg -





ROUDaSSA  
REMPLIR
GNETOUGHE  
REMPLIR
LOLOUSSA  
REMPLIR     <FAIRE -)

REMPORTER     (= gagner)    BAGHA     

RENCONTRER    KWANIA      

GHABOUSSA  
RENDRE

REPARLER     A QUELQU'UN    TATA      CHA MOUTOU

REPAS  ILAXEA

REPETER     (= refaire)     BA  SADA

TSOGHALA  
REPLANTER

REPLIQUER     A      KALA      CHA MAMBA NA

REPONDRE      YAGHOULA  

VOMA     
REPOSER     <SE -)

SEJŒE     
REPROCHER

REPU   LEYOTOUGHA

RESINE PAGHA

RESISTER      DEDA     

RESPECTBOUYIMBA

RESPECTIGHOBICHI

GHOBICHI  
RESPECTER

YIMBOUSSA  
RESPECTER      (= obéir)

RESPECTS      BIGHOBICHI

RESPIRATION  VOMA

RESPONSABILITE      BOUKOUMOU

RESPONSABILITE      BOUCHEPA

RESSEMBLANCE IFVENICHI

RESSEMBLER   FWANA      

FWANASSA   
RESSEMBLER(FAIRE -)
SALA     
RESTER

RESTER     (intransitif)   CHIKA      


-80-





RESTER AU VILLAGE   BA  GHOU BOLA

RESTER DANS UN ENDROIT     SALA  CHA I ITSEGHA

RESTER     SEUL     SALA  CHA BOUTOUBOU

RETENIR      CHIJŒA 

RETOURNER  (SE -)   KALAGHA 

RETROUVER    BAKOUSSA    

REUNIR      (SE -)  KOKOUNA 

REUSSITE     LETOGHA

REUSSITES    MATOGHA

REVE  NDOTI

REVEILLER  <SE -)   SOGHA

REVEILLER QUELQU'UN SOLA     CHA   MOUrOU

REVES M..ANDOTI


REVEURMOULOTI

RHUMATISME   INWA'NGOTJ


RHUMA    T I8MB     3ABIMBA

RHUMATISME  (= ccr~s Da:   NIOUTONGUENGUI

RHU1Œ MAGHOYO

RICANER      CHEBE Cu)

RICANER      SEBE ('J)


RICANER      KIE KIE KIE

RICHE      (substantif)    MOUYOUMOUNOU

RICHES      <sustantif)    MIYOUMOUNOU

RIDE  MOUGNITA

RIDES MIGNITA

RIEN  CHELA VE

RIRE (substantif)   LEKIEKI

RIRE (verbe) SEBE 

RIRES KAKIEKI

RIVAL PALA

-81-





RIVALISER    SA  CHA IPALA

RIVALISER    LOUNA      

RIVIERE      NDZELI
RIZ    MCtTRECHI

ROBE   IRENGA
ROBES  BIRENGA
ROCHER LEMANIA
ROCHERSMAMAGNIA
RONCE  MVOUKOU
RONCES MAMVOUKOU
ROND   CHA DJENGUELE
ROND   GUIGUIDI
ROTIR  KANGA      

ROTULE INDJIBOUGHA     CRA LEBONG~
ROUGE  YA EENGUE
ROUGIR BENGUE      

ROUGIR    (= avoir honte)   MONO      TSOGNI

ROUILLEMALELI
ROULER    (SE -) PAR TERRE  KINGOUDA   YA TOTO
ROULER QUELQUE CHOSE KINGOUSSA   CHELA

ROUSPETER     SA      MA!~DZANGA

ROUTE LARGE   DZELA      I INENI
RUGIR  KAMBAGHA  




. . . . . . . . . . . . . . ... . . . .




    -82





SABLE    MOUNIENGA

SAC      PENGUE

SACRIFICELENDEMBI

SACRIFICES      MADEKBI

SAGAIE   LEKO?lGO

SAISIR      
KYATA

SAISON DES PLUIES      LEKESSE     LOU WvODLOU

SAISON    SECHE MANGALA
SALIR    SA     MBINDA     

SALIVE   LaTE

SALIVES  ~ATE

SAN'G    !iGU I NA

SANGLIER 1lGOY l

SANGSUE  TONGA

SANS TOI VIE BE    C= VE VE)

SANTE    NIOUTOU MBIMBIDI

SAOULER      (SE -)    KOLO  MALAMOU

SATISFAIT      (ETRE   -)     KOGHA     Cu)

SAUTER   VEDE

SAUTERELLE      POP A

SAUTERELLES     BAPOPA

SAUVER   YOBOLO     Cu)

SAUVER   POTO!...f] (u'j




SAUVETJR MOUYOBILI

SAUVEUR  MOUPOTILI

SAVANE   TSEGHE

SAVANT   MOUTOD     A YABA

SAYNETE  IKOtTMBOU

SAYKETES 13 l Ï'-:O{; ME.:-v


SCIE     l G H \I.' ASS    A



,- 83   --





    SCIUREFOUROUFOUCHI

    SCIUREFOURFOUCHI

    SEC   CHI CHA KANIA

    SECOUER      POPOUSSA   

    SECOUER     <intransitif)  TSOKOUNA   

    SECOUER     (transitif)    TSOKOUSSA   

    SECOUSSE     TSOKOUNA

    SBlN  LEBENE

    SEINS MABEllE
    SEIZIEME     CHA LEKOUMI      NA BISSAXOUNA

    SEL   MOUNGWA

    SELLE TCHIBI

    SBLLESKATCHIBI

    SEJŒR  NIANDZA   

    SEMER A LA VOLEE     YEDE

    SENTIR YOGHA

    SENTIR UNE ODEUR     YOGRA<u) CRA TSOULOU

    SEPARERKAGHOULA   

    SEPT   TSAMBA

    SEPTIEJŒ      MOUTSAMBA

    SERPENTTEDI

    SERRER      (avec les bras) VlKA

    SERVIR SADA BlA (+ campI.)

    SERVIR LE REPAS      SADA BIA NDZALA

    SEULEJŒNT     NDILA
    SEULEMENT     LUI    NDlLA NDE
    SI TU N'ES     PAS...WE    VE   BA. . .

    SIFFLETLEPELE
    SIGNE  lLEMBA
    SILENCEBWO

- 84-





SILENCE S'il

SILENCE!   (pluriel)  BADAGNI    BWO
SI LENCE     !    (si ngu li er)    BA BYO
SILENCIEUX     SWI

SILENCIEUX     CHICHA VE NA KELE
SILURE  TOKBI
SILURE  J'GOLO
SINGE   KEXA
SINGES      (ESPECES DE - !) XAPEPE    !
SIX     SAKOUIlA
SIXIEJŒ MOUSSA   KOU NA

SLIP    MOUBETI

SOEUR      (frère et soeur)  KEDI
SOEURS  BAKEDI
SOIF    PEYI A
SOIF (J'AI - D'EAU)   ME PEYA    KAKBA

SOIGNER UNE PLAIE     BOGHA     PINGUI

SOIGNEURKOUBOUGHI
SOINS      (indigènes)MANGANGA
SOIR    MOUKOLO

SOIXANTE-DIX-SEPTIEXE CHA KAKOUMI TSAMBA NA TSAMBA

SOIXANTIEME    CHA MAKOUMI MASSAKOUNA

SOLDAT  MOUGHOLO

SOLEIL  LETEDI
SOLIDE  BOUNONO
SOMMEIL CHOLO
SOMMET  MANENGA
SORCELLERIE    BOULOGHI
SORCIER      (MAUVAIS-)      MOULOGHI
SORCIERS  (MAUVAIS    -)     BALOGHI

- 85-





SORTIE     YI      POULILI
SORTIR     (SE - D'AFFAIRE>    POLA   OUTSO DjAMBA

SORTIR     (intransitif>POLA  

SORTIR     (transitif)  POSSA     

SOUCHE     (ORIGINE)    LESSEME

SOUCHE     (ORIGINE)    LECHINA

SOUCHE D'ARBRE   ICH!llDA

SOUCHES     (ORIGINES)  MACHINA

SOUCHES     <ORIGINES)  MISSEME

SOUCIS    1I..A   TCH l MI

SOUFFLE   VOMA
SOUFFLER  FOULOU      

SOUFFLER    EN TE~~ETE  SA  IKOUNGOU

SOUFFLER    SUR LE FEU  LOSSA     


SOUFFRIR  KaNO  MIMBONDO

SOULAGER  BOCHA     

SOULAGER     (SE -)     NIAKA     Cu)

SOUPCONNERTESSELE   

SOURCE    TSOt1NGOU

SOUVENT   KO

SOUVENT    IEEBELE

SPERME    MABOTA

STATUE     l ~l D J l MA



STATUE     KOKA

STERILITE  INGOUMOU

SUCCEDER     (= remplacer)      !{ITOUSSA (u~

SUCCEDER     (= suivre)  [J(!UKOU

suceES     LETOGHA
)
SUCCESSION     (de choses)      XOUBITI  'toujo~rs sing.

SUCCESSION     <de chos~s)      OT...T!)OUKOUUOU


- 86   --





SUCER  PIPA  

SUEUR  LaROGHANA

SUFFISANT     TCHITSA

SUPPLIER      VONDO

StTRGIRPOLOULA<u)

SURPASSER     LOTA

SURPRENDRE    SOl.JGaSSA


SURPRIS     <ETRE   -)      SOMaGHA

SUSPECTNA KE NDE

SUSPECT     (substantif)    NGA NA TI

SDSPECT     (substantif)    LE7ESSELE

SUSPENDRE     LELaGHE




....................




TABAC  IVOLO

TABOURET      KVlANGA

TAILLE  ITELE

TAILLE      (TOUR DE -)      LEBINDI

TAILLE     (TOURS DE -)      MABINDI

TAILLER      <le bois)VAL A

TAILLER      <statuette)     PAKA  

TALON   LEGHENaGNIE

TAM-TAM NDROUNGOU

TAMS-TAMS      MANDROUNGOtT

TANT PISLI   BA


- 8'!-





    TANTE   PATERNELLE  TAMOUKASSA

    TANTE PATERNELLE    TATAKOUKASSA

    TARO  TSAllGA

    TAROS BATSANGA

    TAS (PETITS -)      BIBOUTOU

    TASSERVI KA   

    TASSERPEPE    

    TATOUAGE     YIMANGA

    TATOUAGE     LEGHOUMBI

    .TEMO IN     IMOUNI

    TEMPETE      IMFOUNGOU

    TEMPETE      MODKOUNGOU

    TEMPS BOTJCHI

    TEKPS      (E~ CE   -   LA)BOUCHT BA GHO~ LEKESSa LENA

    TENDRE UN PIEGE     TEGHE    ?(.:JURAMBA

    TENEBRES     l PFOUND07}

    TENTE ITALaKA

    TENTE      (= ~o:le d'araigilée)  LEBOUNGUILANDZANDA

    TENTER QUELQU'UN   C= séduire)    SOMBO     

    TERMINER      (le vin>     MANA         (ma::'a)

    TERMITIERE   IKOUGHOU

    TERMITIERE   NDZO TCHE DIDI
    TERMITIERES  NDZO BATCHE DI DI

    TERRE TOTO

    TESTICULE    MOUKEGNI

    TESTICULES  MIKEGNI
    TETARD      LETANGA
    TETARDS     KATANGA
    TJETE <HOCHER LA -) TSOKOUSSA CHA MOUTSWE

    KOBA

- 88-
    Licence accordée à Ronnie MVE MEBALE ronmvemebala@gmail.com - ip:88.122.177.93




-    TIQUES BAKOBA
    TIRE LA LANGUE!      DOUTOU     L!LIMI !

    TIRER  DOUTOU      

    TIRER QUELQUE CHOSE  DOUTOUGHOU      CHA CHELA

    TIRER UN COUP DE FUSIL      KIAKA          CHA NDJEDI

    TIRER UN COUP DE FUSIL      KOUNA      NDJEDI

    TIRER UNE FLECHE     PISSaLA  LEBECHI

    TIRER VERS SOIDOUKOU      
    TISANE LETSEGHE
    TISSER KOKO     

    TISSERTOUNGA      

    TOI   WE

    TOI     <PAS    POUR      -)      MOUWE VE

    TOILE D'ARAIGNEE    NDZO     DZANDA

    TOILES D'ARAIGNEES   MISSOUNDJI  MIA NDZANDA

    TOKBE     (substantif)     NGUILA
    TOMBER      (FAIRE  -)      RAGHASSA 

    TOMBER DE SOMMEIL    BONDa      NA CHA CHOLO

    TOY~ER      DU    C l EL    RAGHA      A MATA GHOU YOULOU

    TORCHE MBWAGHA

    TORT      (DONNER-)  BOMA      CHA ISSALA

    TORTUE MOUBOULOUKOU

    TORTUEUX      GHODINI

    TOUCHERBEMBE     

    TOUJOURS     LEKESSE LOSS!
    TOUJOURS (POUR-)    MOU MOUBOU
    TOURNER      DJENGUELE  

    TOURNER  (FAIRE -)  DJENGUESSE     
    TOUSSER      KOSSaLO  

    TOUSSOTEMENT  IKOSSOLO

.-89-





TOUSSOTEMENTS      BIKOSSOLO

TOU'"f      BIOTsr

TOUT <PAS DU -)    KI    KA PESE"A VE

TOUT     PRES     :CE     GHOU PANGA A

TOUTE LA JOURNEE   LETSOUGHOU  LA BOUCHI
TOUX KOSSOLO    KOSSOLO

TOUX INTERMINABLE  IFENGUELE

TRACE    (de   pet.i   t ani ma l )  MWANDA
TRACES    (de petits animaux) MIANDA
    .::
TRAHIR   KABaLA      CHA KASSA

TKAH!SON KABaLAKASS.A..


TRAINER PAR TERRE    <transitif)     BONGOUSSA  (~) MOUTOTO

TRANQUILLITE    TI NGA

TRANSFORMER     KALAGHA     

TRANSf{ETTRE    TOCHI 

TRANSMETTRE (= contaminer)    NAMOUSSA      

TRANSMETTRE (= une nouvelle)  TOSSa  TSANGA

TRANSPERCER     TOUBOU     Cu)

TRANSPIRATION   NDZOUNGUILI

TRANSPIRER      POSSA Cu) CHA ND20DNGUILI

TRA.NSPORTER    BETA Cu)


TRAVAIL  MOT~TD I ANZA


TRAVAIL  ISSALA

TRAVAILLER      DIANDZA     



TRAVAILLEUR     MOt.TSSELI


TRAVAILLEUR     MOUDIENDJI
TRAVAILLEPRS    EASSE!.-I


TRAVAILLEURS    BADIENDJI
TRAVAUX  MIDIANDZA
TRAVAUX     BISSA LA

90-





TRAVERSER      (FAIRE    -)      SABOUSSA      

TRAVERSER     UNE    RIVIERE     SABaGHA       ND2ELI

TREIZIEME   CHA LEKOUMI NA PITATA

TREMBLEMENT LEKAMBA

TREMBLER    TEBE      

TRENTIEME   CRA MAKOUMI MATATA

TRES   MAUVAIS     BOUBI BVA LOUTALA

TRESSER     V AliDA      (\J)



TRESSES     MI VANDA

TRISTE     <ETRE    -)    ROUNGOTJ     ('U)


TROISEITATA   (préf.v~r.pcu~    cardin.)

TROISIEME   MOUTATA

TROMPE     D'ELEPHANT     MOUTCHIPA

TROMPE D'ELEPHANT  MBOtTYI

TROMPER     TOKOUSSO      

TROKPER     (SE -) TOKOUNO      

TROMPER PAR ERREUR     (transitif)      Kourou   

TROMPER QUELQU'UN  TOKOUSSO      Cu) MOUTOU

TROMPES D'ELEPHANT BOtTYI

TROMPES D'ELEPHANT MITCHIPA

TROU (dans la terre>      LEBILA

TROU <de rat)      MOULEKA

TROUPEAU    IVANDA

TROUVER     BAKaSSA      

TROUVER     (SE -) BA     

TU   \lE

TUBERCULE   IGHONGO

TUBERCULE      ,GERME DE -)      MOUTI A IGHONDO

TUBERC~LE      (GRAND -)  MOUDOCDQU

TUEERCULE      <PETIT -,  !{AB I LA


    --91 -





    TUBFRCULES  BIGHONGO

    TUBERCULES    (GRANDS -)  MIDOUDDU

    TUER BDMA   

    TUEURMOUBOUMI

    TUEURS      BABOUMI

    TURBULENCE  BOUVOULOU

    TURBULENCES BIVOULOU

    TURBULENT   IVOULOU

    TURBULENTS  BIVOULOU




    ....................




- 92-





UN   M'JCHI

UN PAQUET   l BOUTO~J1 MO':H!

UNE MAISON  NDZO     IMO

UNE PERSONNEMDUTOU      MOUMOCHI

UNIQtTE    (FILS   -)     M\VANA \VA LEKITA

UNIVERS     POUNGOU

URINE AU LIT (J'-) ME NIAKA MASSOBA GHOtT TENGUI

URINE BEAUCO~?   (T'    -)~E   NIAKA MASSOBA   BOVLEGHI

URINE GOUTTEA G00TTE  (J'-)      ME NIAKA   MASSOBA   LETENGUI-LETENGU

URINE PAS     (JE N'-)    ME NIAKA KASSOBA VE

URINE SOUVENT(J'-) ME NIAKAYGA     MASSOBA

URINER     (J'AI MAL POUR -)     ~E MONANGA    BOUKEGNI    YA ME

URINES      MASSOBA



....................




VA   !YENDE      !

VACCINATION  MANGONGO

VAGIN TSOTO

VAGIN LEVOULOU

VAGIB PENE

VAIN      (EN -)    MOU NDZOLO

VAIS      <JE M'EN -)      ME KA MWENDA

VALISEIGHALA

VANTARDISE   NDZOLA

VAPEURMOUFOUDI

VASE      (la -)    LEBA

VASE     (la -)    MBENDA

    93 -





VEILLEE     IMOGHO
VEILLEE BOTJNGOSSA

VEILLER      (avec obligation)      KISSA   

VEILLER      (i~transitif)   MOGHO   

VEINE   MùUKENGUI
VEINE    <AVOIR DE LA -)     LEKE LA
VEINE    (AVOIR DE LA -)     NIOUTOU BOUBWE
VENDEUR MOUCHOUMBICHI
VENDRE  SOMBOUSSA    

VENDRE BEAUCOUPSOKBOUSSA     MOULEGHI

VE!IGEANCE     PELA
VENGER     (SE -)     KALA  CHA PENDA

VENINS  MIANGOULA
VENT     LEVOGHA
VENTRE   MOGNI
VENTRES  MIOGNI
VENTS    MAVOGHA
VER (= animal)  MOUSSOBI
VERGE    LEKATA
VERIFIER KENGOUSSE     IMBOULI

VERITE   IMBOULI
VERIIIR  NONGA  


VERNIS     (substantif)I LEYJ31

VERRE A BOlEE   KOPO

VERRE A LUNETTESBIEGNI

VERS (= dir~ction)     GHOU PANGA
VERS     (adv.) GHONA
VERSANT  SOKONO G~A MOUKOUDI

VERSER      (SE   -)   YITA ('J)

VEI<:::ER (t r a r!si tif)    y     (tA)
r Tor; l:..A


94   ..
    Licence accordée à Ronnie MVE MEBALE ronmvemebala@gmail.com - ip:88.122.177.93
.~~~m:~~~>~~~"':~':'»~~~:~'~~~'.~~~,;,,~'~:::~~~4'~~:'j:")r{:r~1J'~~~:>A':''"$:%.,'''''~~%ff~W:',"jt~w-~~~~~':,,>,>,:i,,:,,~;~*'::>'::::>"




VERSER    AVEC PRECAUTION     LEKE 

VERSER DANS UN VERRE   SEGHELE 

VERT (= non sec)WA VE KANIA

VESTE    LENGOYI

VETEMENT LENGOYI

VETEMENTSMANGOYI

VEUF     HfJUKOULI

VEUVAGE  f,.JUKOUL  I
VIANDE   NIAMA
VIANDE CRUE     NIAMA WOUMOUBISSA

VIANDE DE BOEUF NGOMBO
VIANDE POURRIE  NIAMA-BaLO

VIDER    YITA  ('J)

VIDER UN SAC    POSSA    <u> CHIA TWA PENGUE

VIEILLESSE      BOUNOUNOU

VIEILLIR NOUNOU     

VIENS    YANGA

VIEUX     INOUNOU

VIEUX    (substantif)  BINOUNOU

VILAIN     (substantif) I-BI

VILAINS(subst~ntif)     BI-BI

VILLAGE   BOLA

VILLAGE   BOULA

VILLAGE(NOUVEAU -)      MtJUPAKA

VILLAGE<VIEUX -) LEEOUGHOU

VILLAGE      EST DETRUIT      (LE -)  BOLA BA MATSAMOUNA

VILLAGES  MALA

VIU      MALA

V I},; rJEP f..LME     TOUTOU

V l Nf.] T      MAKOUMI ~OLI

    - 95 -





    VINGT ET UNIEME     CHA XAKOUMI      MaLI NA IHO

    VINGT-DEUXIEME      CHA XAKOUMI      MaLI NA BIOLI

    VINGTIEME    CRA MAKOUMI      MaLI
    VIPEREPILI
    VIPERES      BAPILI
    VIRER BALOULA    <u)

    VISITEMONO
    VISITER      KOTO     

    VISITEUR     MOUKOTI
    VITESSE      MOUKASSA
'VIVANT     <ETRE   -)      BA   Cu'> MOGNI

    VIVANT     (JE SUIS -)     ME LI MWEGNI
    VIVANTS     (ETRE -)BA Cu) MIOGNI
    VIVANTS     (NOUS SOMMES -)BESSA BENA LE BA MIOGNI
    VOICI MONO

    VOIR  MONO      

    VOIR    (FAIRE -)   MWESSE
    VOIR BIEN    MONO      Cu) BWEDI
    VOIR LA LUMIERE     MONO       IYALaLA

    VOIR LE BIEN MONO      Cu) BOUBWE
    VOIX  NDAGHA
    VOIX    (pluriel)   MANDAGHA
    VOLER    (= s'emparer)     YIBA      Cu)
    VOLER DANS L'AIR     DOUMOUGHOU      

    VOLONTAIREMENTMOU TEBA
    VOMIR  LOGHA     Cu)
    VOMISSEMENT   ILOGHA
    VOMISSEMENTS  BILOGHA
    VO~JLOIR      SAGHA     ru)

    VOULOIRTU!lDO    ('J)



96 -





VOUS  BENA
VOYAGEMOUDZONGA

VOYAGER      KENBA    

VRA l !      GYA !

VRAI    <C'EST    -)MOU KBOULI

VRAI    (substantif)IMBOULI
VULVE MOUTONGA




....................




Y (IL -A)    YI LI    (suivan"'Ç   accord)

Y (J'- VAIS) ME PI YENDE

Y (J'- VAIS) ME PA YENDE

Y AURA <IL -)YI KA BA

Y AVAIT (IL -)      A BA



    .....................




ZENITHYOULOU    MOUTSWE

ZEZAYER <= au-dessusde la langue) YAMBaLA      YA YOULOU A LaLIMI

ZOOLOGIE     MAKBOU     MA BANIAMA
    (      )  o   !
ZUT! mi nee!




..................................................




- 97-





A   <'selon     clas-.se)     DE    (partitif)

A BA     IL Y AVAIT

A KA BA  IL Y AURA

A KA BA NA MVOULOU     IL Y AURA UNE PLUIE

A MATA   DEPUIS    (lieu)

A WE VE  CE N'EST PAS TOI

AGHA     NON

AGNI     BOVE   CE N'EST PAS AINSI

AKA      ALORS

AVION LA INGAMBA (L'-) HELICOPTERE    (= l'avion dame-jeaI




....................




- 9.~





